11111111111111111111
1                  1
1                  1
1         1111111111
1                  1
1    F             1
1         1111111111
1    T             1
1           1      1
1                  1
1                  1
1  F T        P    1
1                  1
1                  1
11111111111111111111
