11111111111111111111
1                  1
1   P              1
1         T        1
1                  1
1    F             1
1         1        1
1 T                1
1           1      1
1  F  F            1
1         1        1
1     T            1
1          1       1
1                  1
11111111111111111111
