  1 1              
   1 1  1111111     
   1 1  1     1     
   1 1  1   T 1     
   1 1  1     1     
   1 1  1  1111     
   1 1  1  1        
111111111  111111111
                    
                  F 
                    
   11111111111111111
   1 1              
 P 1 1              
   1 1              
