           1       
           11111  F 
          1         
         1   1111111
        1   1       
       1   1        
      1   1         
     1   1          
    1   1           
   1   1            
111   1             
     1              
  T  1              
 P   1              
     1              
